hello my â¤ï¸	Hello my love!
good to ğŸ‘€ you ğŸ¤´	Good to see you prince!
my ğŸ¶ said we gone be ğŸ’° one day !!	My dog said we gone be rich one day !!
it's ğŸŒ§ it's ğŸŒ§	it's raining it's pouring
I got so much ğŸ“š let me ğŸƒâ€ ahead and get it over with	I got so much homework let me go ahead and get it over with
I still dont wanna go back to ğŸ«	I still dont wanna go back to school
Let's make some ğŸ’° today	let's make some money today
ğŸ‘¨â€ğŸ’» ğŸ‹ï¸â€ next	work gym next
This little ğŸ§’ has a passion for â˜•ï¸	This little kid has a passion for coffee
I got a ğŸŒ¹ and it made my ğŸŒ	I got a rose and it made my day
4 hours ğŸ˜´ really wish I could switch off!!	4 hours sleep really wish I could switch off!!
Happy â¤ï¸'s Day!	Happy Valentines Day!
This is such a good ğŸ“–	This is such a good read
All âœ¨ @TheLillyFord so ğŸ”¥	All star @TheLillyFord so hot
I'm trying this ğŸ’’ night ğŸ˜‚	I'm trying this wedding night lol
Not a bad ğŸ‘€ to wake up to #venice	Not a bad view to wake up to #venice
I got off my ğŸš—, put the â˜•ï¸ on the roof of the ğŸš— for a second, the ğŸ’¨ ğŸ’¨ and it came right back at my face. No â˜•ï¸ for me	I got off my car, put the coffee cup on the roof of the car for a second, the wind blew and it came right back at my face. No coffee for me
I'm off to ğŸ˜´ I have a ğŸ“ tomorrow	I'm off to sleep I have a test tomorrow
I just want to go on a late ğŸŒƒ ğŸ›³ until the â˜€ï¸ comes â˜ï¸	I just want to go on a late night cruise until the sun comes up
When you have the best ğŸ‘©â€ğŸ‘¦â€ğŸ‘¦ in the ğŸŒ	When you have the best mom in the world
Ahhh, the smell of new âš¾ï¸ and fresh ğŸŒ± in the air!	Ahhh, the smell of new baseballs and fresh turf in the air!
just got a â˜‘ï¸ I'm ready to go ğŸ›	just got a check I'm ready to go shopping
Throws ğŸ“ at these Knicks...so over them!	Throws phone at these Kicks...so over them!
Forget the boring ğŸ and ğŸ¥ dates, ğŸ«, and ğŸ’	forget the boring dinner and movie dates, chocolates, and flowers
if your gonna take forever to reply dont ğŸ“² me at all if your gonna take forever to reply	dont even text me at all
Iâ€™m going to need some ğŸ‘¨â€âš•ï¸ to write me a ğŸ“ to miss ğŸ‘¨â€ğŸ’»	I'm going to need some doctor to write me a note to miss work
Was asked to be 2 guys â¤ï¸ should I say yes to one or both? ğŸ˜‚	Was asked to be 2 guys valentines should i say yes to one or both? Lol
sat ğŸš¬ in the kitchen	Sat smoking in the kitchen
Trying out a #Sangiovese ğŸ·	Trying out a #Sangiovese wine
â¤ï¸ You Buds Here is a random ğŸ”¢: 891617	Love You Buds Here is a random number: 891617
â° to take that ğŸŒ™ cough syrup maybe one ğŸŒ I will no longer be ğŸ¤’	Time to take that nightly gulp of cough syrup maybe one day I will no longer be sick
I â¤ï¸ ğŸ‘€ her ğŸ’ƒ	I love watching her dance
Favorite tweet â¬‡ï¸ ğŸ”‘	Favorite tweet lowkey
It's my ğŸ‚... I ğŸ˜­ cuz I want to!	It's my birthday... I cry cuz I want to!
i like to drink hot ğŸ« during summer and icees during cold times	i like to drink hot chocolate during summer and icees during cold times
I just really want to go ğŸŒï¸ with my dad and ride around in the ğŸŒï¸ cart.....	I just really want to go golfing with my dad and ride around in the golf cart.....
I wanna go the Waffle ğŸ  but I'm lonely	I wanna go the Waffle House but I'm lonely
She's the ğŸ. I love my KRoss more than anything or anybody.	She's the GOAT. I love my KRoss more than anything or anybody.
Iâ€™m craving the ğŸ– I need a tan	Iâ€™m craving the beach I need a tan
Working Saturday and Sunday come get a ğŸ» and a ğŸ’ˆ, HMU!!!!	Working Saturday and Sunday come get a beer and a cut, HMU!!!!
Young ğŸ¦ â¤ï¸ That Come From MoeBlock	Young lion heart That Come From MoeBlock
Fed some ğŸ¦†, went for a ğŸ‘£	Fed some ducks, went for a walk
Your Vikings were ON ğŸ”¥	Your Vikings were ON FIRE
Boom! Drop ğŸ¤. Walk off stage.	Boom! Drop mic. Walk off stage.
I met and fell in â¤ï¸ with this guy today!	I met and fell in love with this guy today!
Jammin on my ğŸ¸ #liveme ChrisItalianStallion:	Jammin on my guitar #liveme ChrisItalianStallion:
Migos is ğŸ”¥ right now	Migos is lit right now
Congrats! Y'all won a ğŸŒ­	Congrats! Y'all won a hot dog
PSA ğŸ have the same rights as ğŸš—	PSA motorcycles have the same rights as cars
@Harry_Styles I need u more than a ğŸŒº needs ğŸŒ¨ more than a ğŸˆ needs air and more than I need breath.Mind following me?	@Harry_Styles I need u more than a flower needs rain more than a balloon needs air and more than I need breath.Mind following me?
Wayne is one of the ğŸ's This song always been some ğŸ”¥ waiting for his new projects	Wayne is one of the goat's This song always been some lit waiting for his new projects
ğŸ maps... lol kinda sounds like you are subtweeting your own sence of direction	apple maps... lol kinda sounds like you are subtweeting your own sence of direction
Goodnight â¤ï¸	Goodnight love
Wow you are talented ğŸ¨ ğŸ–Œ ğŸ’„	Wow you are talented makeup artist
New York &amp; Miami âœˆï¸	New York &amp; Miami flight
Probably a good year ahead of us ğŸ peeps	Probably a good year ahead of us snake peeps
Long time no ğŸ‘€ (with Dinar, Lifi , and tubagus at @pizza_hutid)	Long time no see (with Dinar, Lifi , and tubagus at @pizza_hutid)
Some ğŸˆ ppl will laugh but can learn a ton from Serena	Some football ppl will laugh but can learn a ton from Serena
Fried ğŸŒ with ğŸ¯ and sprinkle.	Fried banana with honey and sprinkle.
â˜•ï¸ ğŸ« - the perfect combination! @CoffeeWeekend17	coffee chocolate - the perfect combination! @CoffeeWeekend17
ğŸ‘‹ğŸ» Back To Reality âœˆï¸ @ Singapore Changi Airport	Bye Back To Reality flying @ Singapore Changi Airport
It's ğŸ”¥ Yeaaaa! Straight ğŸ‘†ğŸ¼ @trvisXX	It's lit Yeaaaa! Straight up @trvisXX
Wanna wake up to the sound of the ğŸŒŠ on the beach	Wanna wake up to the sound of the ocean on the beach
"Best revenge is your ğŸ“°." - @Beyonce	"Best revenge is your paper." - @Beyonce
Happy "B"-day! You're our Queen B ğŸ!	Happy "B"-day! You're our Queen B bee!
PHOTOS: â„ï¸ is back	PHOTOS: snow is back
Meet Jamie! Take a tour of her personal ğŸ¡ learn about her journey as an entrepreneur.â€¦	Meet Jamie! Take a tour of her personal garden learn about her journey as an entrepreneur.â€¦
Check out my ğŸ—£ï¸ from my ğŸ® 4! (Call of DutyÂ®: Modern WarfareÂ® Remastered) live at	Check out my broadcast from my PlayStation 4! (Call of DutyÂ®: Modern WarfareÂ® Remastered) live at
Lord you are ğŸ™, Rejoice in the day ğŸ™ awaits ..	Lord you are Good, Rejoice in the day Blessings awaits ..
ğŸ“… AudioAcrobatÂ® Daily is out!	Today's AudioAcrobatÂ® Daily is out!
Let's do this! bringing the ğŸ“¢ to the !	Let's do this! bringing the noise to the !
ğŸ‡®ğŸ‡³ VS ğŸ‡µğŸ‡° Final bro	India VS Pakistan Final bro
Good ğŸŒ… what the heck!! I wake up to a world going ğŸŒ°!! we need these	Good morning what the heck!! I wake up to a world going nuts!! we need theseâœŒ
I'm moving abroad when my license is up I love the â˜€ï¸ 2 much	I'm moving abroad when my license is up I love the sun 2 much
ğŸ‰ ğŸ‚ TO A HUMBLE BEAST â¤ï¸ you bro thank you for ridin since day 1	HAPPY BIRTHDAY TO A HUMBLE BEAST Love you bro thank you for ridin since day 1 |
Me ğŸ™Œ!	Me too!
Do it with passion (ğŸ“¸ handheld with the a7sii)	Do it with passion (shot handheld with the a7sii)
ğŸ‘Ÿ nmd, available for pre order first ğŸ’¸ policy	Adidas nmd, available for pre order first pay policy
Thankyou my sissy! I'M SO HAPPY TBTB DIMENTION KAMU ğŸ˜‚ blue â¤ï¸ you	Thankyou my sissy! I'M SO HAPPY TBTB DIMENTION KAMU HUEHUEHUE blue loves you
It only takes 1ï¸ person to change your life and I'm ğŸ˜€ I found mine.	It only takes 1 person to change your life and I'm glad I found mine.
I have the worst attitude in ğŸ˜” . idc idc	I have the worst attitude in life . idc idc
ğŸ•› is running âŒ› . We will be closing our order ğŸ“’ for the Father's Day gift hampers and personalised...	Time is running out. We will be closing our order book for the Father's Day gift hampers and personalised...
I would defo not be using your ğŸ‘£ as a ğŸ¤ though xx	I would defo not be using your feet as a microphone though xx
I ğŸ¤” I understand what your saying...I ğŸ¤”	I think I understand what your saying...I think
The ğŸ§ is clear here at	The focus is clear here at
WHEN WILL SANHA â¹ï¸ GROWING? Like legit. I'm just a year younger but darn it, his height is taking him to a whole diff. Level oml	WHEN WILL SANHA STOP GROWING? Like legit. I'm just a year younger but darn it, his height is taking him to a whole diff. Level oml
ğŸ™ G!	thanks G!
There's something in his ğŸ‘€ ğŸ’¤ well baby	There's something in his eyes Rest well baby
Hi fam! Find me in this videoâ€” Check out her youtube channel and subscribe. â€” Help me promote my sister's channel	Hi fam! Find me in this videoâ€” Check out her youtube channel and subscribe. â€” Help me promote my sister's channel
ğŸ˜‚ğŸ˜‚ lol	lol lol
Check Out and ğŸ§ To Moni by Hardx	Check Out and Listen To Moni by Hardx
ğŸŒ± MA said pain so deep I can feel it in my stomach BITCH THATS YA CRAMPS	Young MA said pain so deep I can feel it in my stomach BITCH THATS YA CRAMPS
Help us find - 8 yr old Type 1 with an ğŸ’‰ allergy	Help us find - 8 yr old Type 1 with an insulin allergy
Why is it hard for people to keep it ğŸ’¯...	Why is it hard for people to keep it real...
ğŸ˜‚. I'll save him . Give me that ğŸ‘•!	LOL. I'll save him . Give me that shirt!
Just finished the ğŸ“š with	Just finished the exam with
ğŸ† g can make a guy 10x finer)))):	Golds g can make a guy 10x finer)))):
Couldn't be more PUMPED to ğŸ§ this tonight	Couldn't be more PUMPED to hear this tonight
Nothing a bunch of can't fix!! Still have ğŸ« for that show tomorrow night???	Nothing a bunch of can't fix!! Still have tickets for that show tomorrow night???
ğŸ¶ always heals the soul. Thank you for this!	Music always heals the soul. Thank you for this!
